唉	āi	Hừ, Ừ, Ôi, Dạ, Vâng
爱护	àihù	Bảo vệ, Giữ gìn, Trân quý
爱惜	àixī	Yêu quý, Quý trọng
爱心	àixīn	Tình Yêu thương, lòng yêu thương
岸	àn	Bờ, Bến bờ
安装	ānzhuāng	Lắp đặt, Cài đặt
傍晚	bàngwǎn	Chạng vạng, Gần tối, Sẩm tối, Nhá nhem
办理	bànlǐ	Xử lý
班主任	bānzhǔrèn	Chủ nhiệm lớp; giáo viên chủ nhiệm; giáo viên phụ trách
保存	bǎocún	Bảo tồn
报告	bàogào	Báo cáo
宝贵	bǎoguì	Quý báu
包裹	bāoguǒ	Bưu phẩm, Vật phẩm, Gói hàng
包含	bāohán	Bao hàm, Chứa đựng
保留	bǎoliú	Gìn giữ, Bảo lưu
保险	bǎoxiǎn	Bảo hiểm
把握	bǎwò	Nắm vững, Nắm chắc
倍	bèi	Bội, Bậc, Lần
悲观	bēiguān	Bi quan
背景	bèijǐng	Hậu cảnh, Bối cảnh, Nền
被子	bèizi	Cái chăn, Chăn bông
本科	běnkē	Khoa chính
本领	běnlǐng	Bản lĩnh
本质	běnzhí	Bản chất
便	biàn	Thêm, Càng
编辑	biānjí	Biên tập
辩论	biànlùn	Biện luận, Tranh luận
鞭炮	biānpào	pháo
标点	biāodiǎn	Dấu câu
表格	biǎogé	Bảng, Biểu
表面	biǎomiàn	Bề ngoài, Bề mặt
表明	biǎomíng	Thể hiện
表情	biǎoqíng	Biểu tình, Biểu cảm
表示	biǎoshì	Biểu thị, Bày tỏ
表现	biǎoxiàn	Biểu hiện
表演	biǎoyǎn	Biểu diễn
表扬	biǎoyáng	Biểu dương, Khen ngợi
标志	biāozhì	Dấu hiệu, Kí hiệu
彼此	bǐcǐ	Lẫn nhau
别	bié	Khác
毕竟	bìjìng	Cuối cùng, Dù sao cũng
比例	bǐlì	Tỷ lệ, Tỷ số
避免	bìmiǎn	Tránh khỏi, Thoát khỏi
丙	bǐng	Số 3, Hạng 3, Bính
病毒	bìngdú	Bệnh dịch, Bệnh
饼干	bǐnggān	Bánh quy
并且	bìngqiě	đồng thời
冰箱	bīngxiāng	Tủ lạnh
必然	quèrán	Tất nhiên, Tất yếu, Thế nào cũng
比如	lìrú	Ví dụ, Chẳng hạn như
必须	bìxū	Tất yếu, Thế nào cũng
必要	bìyào	Cấn thiết, Thiết yếu, Tất yếu
玻璃	bōlí	Gương, Thủy tinh
博士	bóshì	Tiến sĩ
博物馆	bówùguǎn	Viện bảo tàng
脖子	bózi	Cổ
布	bù	Bố, (vải bố, tuyên bố)
不好意思	bù hǎoyìsi	Xấu hổ, Mắc cỡ, Ngại, Không tiện
不耐烦	bú nàifán	Sốt ruột, Không kiên nhẫn
不安	bù’ān	Bất an
不必	búbì	Không cần thiết
补充	bǔchōng	Bổ sung
不得了	bùdéliǎo	Quá, Quá sức, Cực kì
不断	búduàn	Không ngừng
部分	bùfèn	Bộ phận
不见得	bújiàn dé	Chưa chắc, Chưa từng
部门	bùmén	Bộ môn; ngành; chi; nhánh, bộ phận
不免	bùmiǎn	Không tránh được, Sao khỏi
不然	bùrán	Không phải, Không phải vậy, Nếu không thì
不如	bùrú	Không bằng, Thua kém hơn
不要紧	búyàojǐn	Không sao cả, Không hề gì
步骤	bùzhòu	Bước, Bước đi, Trình tự
不足	bùzú	Không đủ, Thiếu, Chưa đạt
踩	cǎi	Dẫm, Đạp, Dậm (chân)
财产	cáichǎn	Tài sản, Của cải
采访	cǎifǎng	Phỏng vấn
彩虹	cǎihóng	Cầu vồng
采取	cǎiqǔ	Áp dụng, Dùng, Thực hành
残疾	cánjí	Tàn tật
参考	cānkǎo	Tham khảo
惭愧	cánkuì	Xấu hổ, Hổ thẹn
餐厅	cāntīng	Phòng ăn, Nhà ăn
参与	cānyù	Tham gia, Tham dự
操场	cāochǎng	Thao trường
操心	cāoxīn	Bận tâm, Nhọc lòng, Lo nghĩ
册	cè	Quyển, cuốn
曾经	céngjīng	Đã từng
厕所	cèsuǒ	Nhà vệ sinh
测验	cèyàn	Thực nghiệm
插	chā	Cắm, Đút
差别	chābié	Khác biệt
拆	chāi	Mở ra, Tháo ra, Gỡ ra
常识	chángshì	Thường thấy
长途	chángtú	Đường dài
产品	chǎnpǐn	Sản phẩm
产生	chǎnshēng	Sản sinh, Nảy sinh, Xuất hiện
朝	cháo	ngoảnh mặt về; hướng về
炒	chǎo	Xào, Món xào
抄	chāo	Sao, Sao chép
朝代	cháodài	Triều đại
吵架	chǎojià	Cãi nhau
叉子	chāzi	Cãi dĩa, Nĩa, Xiên, Ngã ba
彻底	chèdǐ	Triệt để, Đến cùng
车库	chēkù	Gara, Nhà để xe ô tô
趁	chèn	Nhân lúc, Thừa dịp
称	chēng	Xưng, Gọi, Hô
承担	chéngdān	Đảm đương, Gánh vác
程度	chéngdù	Trình độ, Mức độ
成分	chéngfèn	Thành phần
成果	chéngguǒ	Thành quả, Kết quả
成就	chéngjiù	Thành tựu
诚恳	chéngkěn	Thành khẩn
成立	chénglì	Thành lập
承认	chéngrèn	Thừa nhận
程序	chéngxù	Quá trình, Trình tự
成语	chéngyǔ	Thành ngữ
称赞	chēngzàn	Tán thưởng, Khoan nghênh, Khen ngợi
成长	chéng zhǎng	Trưởng thành
沉默	chénmò	Trầm mặc
车厢	chēxiāng	Toa hàng khách, Thùng xe ô tô
翅膀	chìbǎng	Đôi cánh
吃亏	chīkuī	Thiệt thòi
持续	chíxù	Tiếp tục
池子	chízi	Ao, Vũng
尺子	chǐzi	Thước kẻ
冲	chōng	Đâm, Xông
充电器	chōngdiàn qì	Bộ sạc điện
充分	chōngfèn	Dồi dào, Đầy đủ
重复	chóngfù	Lặp lại lần nữa
充满	chōngmǎn	Lấp đầy, Làm đầyây, Tràn đầy
宠物	chǒngwù	Vật nuôi, Sủng vật
臭	chòu	Hôi
丑	chǒu	Xấu
抽屉	chōutì	Ngăn kéo
抽象	chōuxiàng	Trừu tượng
除	chú	Trừ
传播	chuánbōò	Truyền bá, Phổ biến
传递	chuándì	Chuyền, Chuyển
闯	chuǎng	Xông, Đâm bổ
窗户	chuānghù	Cửa sổ
窗帘	chuānglián	Rèm cửa
创造	chuàngzào	Sáng tạo, Tạo ra cái mới
传染	chuánrǎn	Truyền nhiễm
传说	chuánshuō	Truyền thuyết
传统	chuántǒng	Truyền thống
除非	chúfēi	Trừ phi, Trừ khi
吹	chuī	thổi
初级	chūjí	Bước đầu, Sơ bộ, Cơ sở
出口	chūkǒu	Xuất khẩu, Lối ra, Lối thoát
处理	chǔlǐ	Xử lý, Giải quyết
出色	chūsè	Xuất sắc
出席	chūxí	Dự họp, Có mặt
次要	cì yào	Thứ yếu, Không quan trọng
磁带	cídài	Băng, Băng từ
刺激	cìjī	Kích thích
此外	cǐwài	Ngoài ra
辞职	cízhí	Từ chức
从此	cóngcǐ	Từ đây
从而	cóng’ér	Do đó, Vì vậy, Vì thế
匆忙	cōngmáng	Bận rộn, Hối hả
从前	cóngqián	Trước đây
从事	cóngshì	Làm, Tham gia, Dấn thân
醋	cù	Dấm, Chua
促进	cùjìn	Thúc tiến
存	cún	Tồn
存在	cúnzài	Tồn tại
措施	cuòshī	Cách thức, Phương thức, Biện pháp
错误	cuòwù	Sai lầm, Sai sót, Nhầm lẫn, Lỗi
促使	cùshǐ	Thúc đẩy
打喷嚏	dǎ pēntì	Hắt xì
大象	dà xiàng	Con voi
达到	dádào	Đạt được, Đạt tới
大方	dàfāng	Phóng khoáng, Hào phóng
打工	dǎgōng	Làm việc
呆	dāi	Ở, dừng lại, Ngẩn ngơ, trơ ra
贷款	dàikuǎn	Vay, Cho vay
待遇	dàiyù	Đãi ngộ
打交道	dǎjiāodaào	Chào hỏigiao tiếp; giao thiệp; liên hệ; quan hệ; tiếp xúc
淡	dàn	Nhạt
单纯	dānchún	Đơn thuần
单调	dāndiào	Đơn điệu, Tẻ nhạt, Nhàm chán
单独	dāndú	Đơn độc
挡	dǎng	Ngăn, Ngăn chặn, Che đậy, Gánh
当代	dāngdài	Đương đại, hiện đại
担任	dānrèn	Đảm nhận
单位	dānwèi	Đơn vị
耽误	dānwuù	Làm lỡ
胆小鬼	dǎnxiǎoguǐ	Quỷ nhát gan
单元	dānyuán	Bài mục
倒	dào	Đảo, lộn, Gục
岛	dǎo	Hòn đảo
到达	dàodá	Đến
道德	dàodé	Đạo đức
道理	dàolǐ	Đạo lý, Lý lẽ
倒霉	dǎoméi	Đen đủi
导演	dǎoyǎn	Đạo diễn
导致	dǎozhì	Dẫn đến
大厅	dàtīng	Phòng khách, đại sảnh
大型	dàxíng	Cỡ to
答应	dāyìng	Đáp ứng, Đồng ý
打招呼	dǎzhāohuū	Chào hỏi
登机牌	dēng jī pái	Thẻ lên máy bay, Vé máy bay
等待	děngdài	Đợi chờ
等级	děngjí	Cấp bậc, Level
等候	děnghòu	Chờ đợi
等于	děngyú	Bằng với
递	dì	Chuyển, Đưa
滴	dī	Giọt, Tí tách (âm thanh)
电池	diànchí	Ắc quy, Pin
电台	diàntái	Đài truyền hình
点头	diǎntóu	Gật đầu
电信	diànxìn	Điện tín
钓	diào	Móc, câu
地理	dìlǐ	Địa lí
顶	dǐng	Đỉnh, ngọon, Chóp
丁	dīng	Con trai, Chỉ ng làm việc gì đó…., Họ: Đinh
地区	dìqū	Khu vực
的确	díquè	Chính xác
敌人	dírén	Kẻ địch
地毯	dìtǎn	Thảm
地位	dìwèi	Địa vị, Vị trí
地震	dìzhèn	Địa chấn, Động đất
洞	dòng	Hang động, Động, Lỗ
冻	dòng	Đông (lạnh)
动画片	dònghuà piàn	Phim hoạt hình
逗	dòu	Đùa giỡn, Pha trò, Đậu
豆腐	dòufu	Đậu phụ
短信	duǎnxìn	Tin nhắn
堵车	dǔchē	Kẹt xe
堆	du ī	Đống
对比	duìbǐ	So với, Đối với
对待	duìdài	Đối đãi, Đối xử
对方	duìfāng	Đối phương, Bên kia
对手	duìshǒu	Đối thủ
对象	duìxiàng	Đối tượng
对于	duìyú	Đối với
独立	dúlì	Độc lập
吨	dūn	Tấn
蹲	dūn	Quỳ
躲藏	duǒcáng	Trốn tránh
多亏	duōkuī	May làm sao
多余	duōyú	Dư thừa, Thừa thãi
独特	dútè	Độc đáo
恶劣	èliè	Ác liệt
发愁	fāchóu	Buồn sầu, U sầu, Phát sầu
发达	fādá	Phát đạt, Phát triển
发抖	fādǒu	Run rẩy
发挥	fāhuī	Phát huy
罚款	fákuǎn	Khoản phạt
发明	fǎ míng	Phát minh
翻	fān	Lật
反而	fǎn’ér	Ngược lại, Nhưng mà
反复	fǎnfù	Nhiều lần, Lắp đi lặp lại, Hết lần này đến lần khác
方	fāng	Vuông, Phương, Chiếc
妨碍	fáng’ài	Gây trở ngại, Ảnh hưởng
方案	fāng’àn	Phương án, Kế hoạch
房东	fángdōng	Chủ trọ, Chủ cho thuê
仿佛	fǎngfú	Dường như
方式	fāngshì	Phương thức
放松		Thoải mái
繁荣	fánróng	Phồn vinh
凡是	fánshì	Phàm là
反应	fǎnyìng	Phản ứng
反映	fǎnyìng	Phản ánh
反正	fǎnzhèng	Dù cho, Cho dù, Thế nào cũng
发票	fāpiào	Phát vé
发言	fǎ yán	Phát ngôn
法院	fǎyuàn	Tòa án
非	fēi	Phi, Không
肺	fèi	Phổi
废话	fèihuà	Lời nhảm
费用	fèiyòng	Chi phí, Phí tổn
肥皂	féizào	Xà phòng, Xà bông
分别	fēnbié	Phân biệt
分布	fēnbù	Phân bố
奋斗	fèndòu	Phấn đấu
纷纷	fēnfēn	Ồn ào, Nhộn nhịp
讽刺	fèng cì	Châm biếm, Mỉa mai, Trào phúng
风格	fēnggé	Phong cách
风俗	fēngsú	Phong tục
风险	fēngxiǎn	Nguy hiểm
愤怒	fènnù	Phẫn nộ
分配	fēnpèi	Phân phối, Bố trí
分析	fēnxī	Phân tích
否定	fǒudìng	Phủ định
否认	fǒurèn	Phủ nhận
幅	fú	Bức, Phú
扶	fú	Vịn, Đỡ, Dìu
服从	fúcóng	Phục tùng, Vâng lời
辅导	fǔdǎo	Phụ đạo
复制	fùzhì	Phục chế, Làm lại
付款	fùkuǎn	Thanh toán, Trả tiền, Chuyển khoản
妇女	fùnǚ	Phụ nữ
服装	fúzhuāng	Trang phục
盖	gài	đậy
改革	gǎigé	Cải cách, Cải thiện
改进	gǎijìn	Cải tiến
概括	gàikuò	Khái quát, Nhìn chung, Tổng thể
概念	gàiniàn	Khái niệm
改善	gǎishàn	Cải thiện
改正	gǎizhèng	Cải chính, Đính chính, Sửa chữa
干活儿	gàn huó er	Làm việc
钢铁	gāngtiě	Gang thép
感激	gǎnjī	Cảm kích
赶紧	gǎnjǐn	Nhanh chóng
赶快	gǎnkuài	Gấp rút, Nhanh chóng
感受	gǎnshòu	Cảm nhận
感想	gǎnxiǎng	Cảm tưởng, Cảm nghĩ
搞	gǎo	Làm
告别	gàobié	Cáo biệt, Cáo từ
高档	gāodàng	Cao cấp
高速公路	gāosù gōnglù	Đường cao tốc
隔壁	gébì	Sát vách
个别	gèbié	Riêng lẻ, Riêng biệt, Cá biệt
胳膊	gēbó	Cánh tay
革命	gémìng	Cách mạng
根	gēn	Gốc, rễ, Dây (lượng từ)
根本	gēnběn	Căn bản
更加	gèngjiā	Gia tăng, Cộng thêm
个人	gè rén	Cá nhân
格外	géwài	Vẻ bề ngoài
个性	gèxìng	Tính cách
鸽子	gēzi	Bồ câu
公布	gōngbù	Công bố
工厂	gōngchǎng	Công xưởng, Nhà máy
工程师	gōngchéngshī	Kỹ sư
功夫	gōngfū	Công phu
公开	gōngkāi	Công khai
功能	gōngnéng	Công năng
公平	gōngpíng	Công bằng
工人	gōngrén	Công nhân
贡献	gòngxiàn	Cống hiến
工业	gōngyè	Công nghiệp
公寓	gōngyù	Chung cư
公园	jiànmiàn	Công viên
公主	gōngzhǔ	Công chúa
构成	gòuchéng	Cấu thành
沟通	gōutōng	Khai thông, Khơi thông, Giao tiếp
挂号	guàhào	Lấy số
乖	guāi	Ngoan
怪不得	guàibùdé	Trả trách, Thảo nào
拐弯	guǎiwān	Rẽ ngoặt, Rẽ
官	guān	Quan, Nhân viên
观点	guāndiǎn	Quan điểm
关闭	guānbì	Đóng cửa
观察	guānchá	Quan sát
官场	guānchǎng	Quan trường
广大	guǎngdà	Rộng rãi, Rộng lớn, To lớn
广泛	guǎngfàn	Phổ biến, Rộng rãi, Khắp nơi
光滑	guānghuá	Trơn tuột, Trơn nhẵn
光临	guānglín.	Đến thăm
光明	guāngmíng	Quang minh
光盘	guāngpán	CD
光荣	guāngróng	Quang vinh, Vinh dự
关怀	guānhuái	Quan tâm, Kỳ vọng
冠军	guànjūn	Quán quân
观念	guānniàn	Quan niệm
罐头	guàntóu	Đồ hộp, Vò, lọ, hũm, lon
管子	guǎnzi	Ống, Ống dẫn
古代	gǔdài	Cổ đại
古典	gǔdiǎn	Cổ điển
固定	gùdìng	Cố định
姑姑	gūgū	Cô, Cô cô
规矩	guījǔ	Quy cách
规律	guīlǜ	Quy luật
规模	guīmó	Quy mô
柜台	guìtái	Quầy
规则	guīzé	Quy tắc
古老	gǔlǎo	Cũ kĩ, Cổ
滚	gǔn	Cút, Biến đi, Đi ra, Tránh ra
顾念	gùaniàn	Quan tâm
过	guò	Quá, Đã
锅	guō	Nồi
过期	guòqí	Quá date, Quá thời gian
过分	guòfèn	Quá mức, Quá đáng, Quá phận
国际	guójì	Quốc tế
国民	guómín	Quốc dân
国庆节	guóqìng jié	Quốc khánh
果实	guǒshí	Quả thực
股票	gǔpiào	Cổ phiếu, Chi phiếu
故事	gùshì	Sự cố, Câu chuyện
固体	gùtǐ	Cụ thể, (vật) rắn
骨头	gǔtou	Xương
鼓舞	gǔwǔ	Cổ vũ
雇佣	gùyōng	Thuê mướn
哈	hā	Ha
海关	hǎiguān	Hải quan
海鲜	hǎixiān	Hải dương
航班	hángbān	Hàng không, Chuyến bay
行业	hángyè	Công việc, Ngành việc
豪华	háohuá	Hào hoa
好奇	hàoqí	Tò mò, Hiếu kỳ
何必	hébì	Hà tất
合法	héfǎ	Hợp pháp
何况	hékuàng	Huống hồ
合理	hélǐ	Hợp lý
恨	hèn	Hận
横	héng	Ngang, Hàng ngang
和平	hépíng	Hòa bình
合同	hétóng	Hợp đồng
核心	héxīn	Trung tâm, Hạt nhân, Nòng cốt
合影	héyǐng	Chụp ảnh chung
合作	hézuò	Hợp tác
后果	hòuguǒ	Hậu quả
壶	hú	Ấm (trà)
滑冰	huábīng	Trượt băng
划船	huáchuán	Chèo thuyền
怀念	huáiniàn	Hoài niệm, Nhớ mong
皇帝	huángdì	Hoàng đế
皇后	huánghòu	Hoàng hậu
黄瓜	huángguā	Dưa vàng, Dưa chuột
黄金	huángjīn	Hoàng kim
慌张	huāngzhāng	Hoảng loạn
环节	huánjié	Vòng tuần hoàn, Liên tiếp
幻想	huànxiǎng	Tưởng tượng, Mộng tưởng, Hoang tưởng
花生	huāshēng	Đậu phộng
话题	huàtí	Chủ đề
化学	huàxué	Hóa học
华裔	huáyì	Người gốc Hoa
蝴蝶	húdié	Bướm
灰	huī	Màu xám
挥	huī	Vẫy (tay), Phất
灰尘	huīchén	Bụi đất, Bụi bặm
回复	huífù	Trả lời, Hồi âm, Hồi phục
汇率	huìlǜ	Tỷ suất, Tỷ giá hối đoái
回信	huíxìn	Hồi đáp, Trả lời thư
婚礼	hūnlǐ	Hôn lễ
婚姻	hūnyīn	Hôn nhân
伙伴	huǒbàn	Đồng đội, Đồng bọn, Nhóm
火柴	huǒchái	Diêm, Diêm quẹt
活跃	huóyuè	Hoạt bát
护士	hùshì	Hộ sĩ, Y tá
忽视	hūshì	Xem nhẹ, Coi thường
胡说	húshuō	Nói lung tung
胡同	hútòng	Ngõ, Hẻm
糊涂	hútú	Bối rối, Mơ hồ
呼吸	hūxī	Hô hấp
胡须	húxū	Râu
嫁	jià	Gả
甲	jiǎ	Giả, Thứ 1
嘉宾	jiābīn	Khách hàng
捡	jiǎn	Nhặt
煎	jiān	Rán, chiên, Sắc, pha (trà, thuốc)
肩膀	jiānbǎng	Vai
剪刀	jiǎndāo	Dao kéo
讲究	jiǎngjiù	Chú ý, Coi trọng, Xem trọng
降落	jiàngluò	Lìa cành, Hạ xuống, Hạ phàm, Rời đi
酱油	jiàngyóu	Nước tương
讲座	jiǎngzuò	Tọa đàm, Báo cáo
艰巨	jiānjù	Gian khổ, Gay go
坚决	jiānjué	Kiên quyết
艰苦	jiānkǔ	Gian khổ
建立	jiànlì	Thành lập, Ra đời, Gây dựng
简历	jiǎnlì	Lý lịch, Lý lịch tóm tắt
键盘	jiànpán	Bàn phím
坚强	jiānqiáng	Kiên cường, Mạnh mẽ
尖锐	jiānruì	Sắc bén, sắc nhọn, Sắc sảo, Chói tai, kịch liệt
建设	jiànshè	Xây dựng
健身房	jiànshēnfáng	Phòng tập (gym)
建议	jiànyì	Gợi ý, Kiến nghị
简直	jiǎnzhí	Quả là, Thật là, Tưởng chừng như là
建筑	jiànzhú	Kiến trúc
浇	jiāo	Tưới, Dội
教材	jiàocái	Tài liệu giảng dạy, Tài liệu dạy học
角度	jiǎodù	Góc độ
狡猾	jiǎohuá	Giảo hoạt, Gian xảo, Láu cá, Đạo đức giả
交换	jiāohuàn	Trao đổi, Đổi
交际	jiāo jì	Giao tiếp
放松	fàngsōng	Thoải mái
